0000111000000000000000000000
0000000000000000000000000000
0001111000000000000000000000
0000000000000000001111000000
000000000P000000011000011100
0000001100000000111000000000
0000011100000011000001111011
0000111100000011000000000111
1111111111111111111111111111